+-----------------------------+
|-----------------------------|
||...........................||
||...........................||
||...........................||
||...........................||
||...........................||
||...........................||
||...........................||
||...........................||
||...........................||
||...........................||
||...........................||
||...........................||
||...........................||
||...........................||
||...........................||
||...........................||
||...........................||
||...........................||
|-----------------------------|
+-----------------------------+