.........++
.......+--|
......++.||
.....++..||
....++...||
...++....||
..++.....||
.++......||
++.......||
.........||
.........||
.........||
.........||
.........||
.........||
.........||
.........||
.........||
.........||
.........||
.........||
 +-------------------+