+-----------------------------+
+-----------------------------|
.............................||
.............................||
.............................||
.............................||
.............................||
.............................||
.............................||
.............................||
.............................||
+-----------------------------|
|-----------------------------|
||.............................
||.............................
||.............................
||.............................
||.............................
||.............................
||.............................
|-----------------------------|
+-----------------------------+