+-----------------------------+
+-----------------------------|
.............................||
.............................||
.............................||
.............................||
.............................||
.............................||
.............................||
.............................||
.............................||
+-----------------------------|
+-----------------------------|
.............................||
.............................||
.............................||
.............................||
.............................||
.............................||
.............................||
+-----------------------------|
+-----------------------------+